XXXXXXXXXXXXXXXXXXXXXXXXXX
XOOOOOOOOOOOOOOOOOOOOOOOOX
XOOOOOOOOOOOOOOOOOOOOOOOOX
XOOVVOOOOOOOOOOOOOOOOOOOOX
XOOVVOOOOOOOOOOOOOOOOOOOOX
XOOVVOOOOOOOOOOOOOOOOOOOOX
XOOOOOOOOOOOOOOOOOOOOOOOOX
XOOOOOOOOOOOOOOOOOOOOOOOOX
XOOOOOOOOOOOOOOOOOOOOOOOOX
XOOOOOOOOOOOOOOOOOOOOOOOOX
XOOOOOOOOOOOOOOOOOOOSSOOOX
XOOOOOOOOOOOOOOOOOOOSSOOOX
XOOOOOOOOOOOOOOOOOOOOOOOOX
XOOOOOOOOOOOOOOOOOOOOOOOOX
XXXXXXXXXXXXXXXXXXXXXXXXXX

---

XXXXXXXXXXXXXXXXXXXXXXXXXX
XOOOOOOOOOOOOOOOOOOOOOOOOX
XOOOOOOOOOOOOOOOOOOOOOOOOX
XOOVVOOOOOOOOOOOOOOOOOOOOX
XOOVVOOOOOOOOOOOOOOOOOOOOX
XOOVVOOOOOOOOOOOOOOOOOOOOX
XOOOOOOOOOOOOOOOOOOOOOOOOX
XOOOOXXXXXXXXXXXXXXXXOOOOX
XOOOOOOOOOOOOOOOOOOOOOOOOX
XOOOOOOOOOOOOOOOOOOOOOOOOX
XOOOOOOOOOOOOOOOOOOOSSOOOX
XOOOOOOOOOOOOOOOOOOOSSOOOX
XOOOOOOOOOOOOOOOOOOOOOOOOX
XOOOOOOOOOOOOOOOOOOOOOOOOX
XXXXXXXXXXXXXXXXXXXXXXXXXX

---

XXXXXXXXXXXXXXXXXXXXXXXXXX
XOOOOOOOOOOOOOOOOOOOOOOOOX
XOOVVOOOOOOOOOOOOOOOOOOOOX
XOOVVOOOOOOXXXOOOOOOOOOOOX
XOOVVOOOOOOXXXOOOOOOOOOOOX
XOOOOOOOOOOXXXOOOOOOOOOOOX
XOOOOOOOOOOXXXOOOOOOOOOOOX
XOOOOOOOOOOXXXXXXXXXXOOOOX
XOOOOOOOOOOXXXOOOOOOOOOOOX
XOOOOOOOOOOXXXOOOOOOOOOOOX
XOOOOOOOOOOXXXOOOOOOSSOOOX
XOOOOOOOOOOXXXOOOOOOSSOOOX
XOOOOOOOOOOOOOOOOOOOOOOOOX
XOOOOOOOOOOOOOOOOOOOOOOOOX
XXXXXXXXXXXXXXXXXXXXXXXXXX

---

XXXXXXXXXXXXXXXXXXXXXXXXXX
XOOOOOOOXXXXXXOOOOOOOOOOOX
XOOXXXXXXXOOOOXXXOOOOOOOOX
XOOVVOOOOOOOOOOOOOOOOOOOOX
XOXVVOOOOOOOOOOOOOOOOOOOOX
XXOVVOOOOOOOOOOOOOOOOOOOOX
XOOOOOOOOOOOOOOOOOOOOOOOOX
XOOOOXXXXXXXXXXXXXXXXOOOOX
XOOOOOOXXOOOOOOOOOOOOOOOOX
XOOOOOOOOXXOOOOOOOOOOOOOOX
XOOOOOOOOOOXOOOOOOOOSSOOOX
XOOOOOOOOOOOOOOOXOOOSSOOOX
XOOOOOOOOOOOOOOOOOOOXOOOOX
XOOOOOOOOOOOOOOOOOOOOOXOOX
XXXXXXXXXXXXXXXXXXXXXXXXXX
