XXXXXXXXXXXXXXXXXXXXXXXXXX
XOOOOOOOOOOOOOOOOOOOOOOOOX
XOOOOOOOOOOOOOOOOOOOOOOOOX
XOOOOOOOOOOOOOOOOOOOOOOOOX
XOOVVOOOOOOOOOOOOOOOOOOOOX
XOOVVOOOOOOOOOOOOOOOOOOOOX
XOOOOOOOOOOOOOOOOOOOOOOOOX
XOOOOOOOOOOOOOOOOOOOOOOOOX
XOOOOOOOOOOOOOOOOOOOOOOOOX
XOOOOOOOOOOOOOOOOOOOOOOOOX
XOOOOOOOOOOOOOOOOOOOSSOOOX
XOOOOOOOOOOOOOOOOOOOSSOOOX
XOOOOOOOOOOOOOOOOOOOOOOOOX
XOOOOOOOOOOOOOOOOOOOOOOOOX
XXXXXXXXXXXXXXXXXXXXXXXXXX

---

XXXXXXXXXXXXXXXXXXXXXXXXXX
XOOOOOOOOOOOOOOOOOOOOOOOOX
XOOOOOOOOOOOOOOOOOOOOOOOOX
XOOOOOOOOOOOOOOOOOOOOOOOOX
XOOVVOOOOOOOOOOOOOOOOOOOOX
XOOVVOOOOOOOOOOOOOOOOOOOOX
XOOOOOOOOOOOOOOOOOOOOOOOOX
XOOOOXXXXXXXXXXXXXXXXOOOOX
XOOOOOOOOOOOOOOOOOOOOOOOOX
XOOOOOOOOOOOOOOOOOOOOOOOOX
XOOOOOOOOOOOOOOOOOOOSSOOOX
XOOOOOOOOOOOOOOOOOOOSSOOOX
XOOOOOOOOOOOOOOOOOOOOOOOOX
XOOOOOOOOOOOOOOOOOOOOOOOOX
XXXXXXXXXXXXXXXXXXXXXXXXXX

---

XXXXXXXXXXXXXXXXXXXXXXXXXX
XOOOOOOOOOOOOOOOOOOOOOOOOX
XOOOOOOOOOOOOOOOOOOOOOOOOX
XOOVVOOOOOOXXXOOOOOOOOOOOX
XOOVVOOOOOOXXXOOOOOOOOOOOX
XOOOOOOOOOOXXXOOOOOOOOOOOX
XOOOOOOOOOOXXXOOOOOOOOOOOX
XOOOOOOOOOOXXXXXXXXXXOOOOX
XOOOOOOOOOOXXXOOOOOOOOOOOX
XOOOOOOOOOOXXXOOOOOOOOOOOX
XOOOOOOOOOOXXXOOOOOOSSOOOX
XOOOOOOOOOOXXXOOOOOOSSOOOX
XOOOOOOOOOOOOOOOOOOOOOOOOX
XOOOOOOOOOOOOOOOOOOOOOOOOX
XXXXXXXXXXXXXXXXXXXXXXXXXX